
abattant::=+Afpms-
abattante::abattant+Afpfs-
abattants::abattant+Afpmp-
abattantes::abattant+Afpfp-

abergement::=+Ncms--
abergements::abergement+Ncmp--

adhérant::=+Afpms-
adhérante::adhérant+Afpfs-
adhérants::adhérant+Afpmp-
adhérantes::adhérant+Afpfp-

adimensionnel::=+Afpms-
adimensionnelle::adimensionnel+Afpfs-
adimensionnels::adimensionnel+Afpmp-
adimensionnelles::adimensionnel+Afpfp-

adjuvantation::=+Ncfs--
adjuvantations::adjuvantation+Ncfp--

adjuvanté::=+Afpms-
adjuvantée::adjuvanté+Afpfs-
adjuvantées::adjuvanté+Afpfp-
adjuvantés::adjuvanté+Afpmp-

admixture::=+Ncfs--
admixtures::admixture+Ncfp--

affectataire::=+Ncms--
affectataires::affectataire+Ncmp--

affleurant::=+Afpms-
affleurante::affleurant+Afpfs-
affleurants::affleurant+Afpmp-
affleurantes::affleurant+Afpfp-

agglo::=+Ncms--
agglos::agglo+Ncmp--

agrafure::=+Ncfs--
agrafures::agrafure+Ncfp--

ajustable::=+Afpms-
ajustables::ajustable+Afpmp-

alentour::=+Ncms--
alentours::alentour+Ncmp--

algicide::=+Ncms--
algicides::algicide+Ncmp--

alkyde::=+Ncms--
alkydes::alkyde+Ncmp--

alternant::=+Afpms-
alternante::alternant+Afpfs-
alternants::alternant+Afpmp-
alternantes::alternant+Afpfp-

altimétrique::=+Afpms-
altimétriques::altimétrique+Afpmp-

aluminié::=+Afpms-
aluminiée::aluminié+Afpfs-
aluminiés::aluminié+Afpmp-
aluminiées::aluminié+Afpfp-

aluminoferrite::=+Ncfs--
aluminoferrites::aluminoferrite+Ncfp--

ambient::=+Afpms-
ambiente::ambient+Afpfs-
ambients::ambient+Afpmp-
ambientes::ambient+Afpfp-

amené::=+Afpms-
amenée::amené+Afpfs-
amenés::amené+Afpmp-
amenées::amené+Afpfp-

amianté::=+Afpms-
amiantée::amianté+Afpfs-
amiantés::amianté+Afpmp-
amiantées::amianté+Afpfp-

amortissant::=+Afpms-
amortissante::amortissant+Afpfs-
amortissants::amortissant+Afpmp-
amortissantes::amortissant+Afpfp-

amorçant::=+Afpms-
amorçante::amorçant+Afpfs-
amorçants::amorçant+Afpmp-
amorçantes::amorçant+Afpfp-

antichute::=+Afpms-
antichutes::antichute+Afpmp-

anticontaminant::=+Afpms-
anticontaminante::anticontaminant+Afpfs-
anticontaminants::anticontaminant+Afpmp-
anticontaminantes::anticontaminant+Afpfp-

antiflambement::=+Afpms-
antiflambements::antiflambement+Afpmp-

antiparasitaire::=+Afpms-
antiparasitaires::antiparasitaire+Afpmp-

antipoussière::=+Afpms-
antipoussières::antipoussière+Afpmp-

antivibratile::=+Afpms-
antivibratiles::antivibratile+Afpmp-

appenti::=+Ncms--
appentis::appenti+Ncmp--

armaturier::=+Afpms-
armaturiers::armaturier+Afpmp-

armé::=+Afpms-
armée::armé+Afpfs-
armés::armé+Afpmp-
armées::armé+Afpfp-

assemblé::=+Afpms-
assemblée::assemblé+Afpfs-
assemblés::assemblé+Afpmp-
assemblées::assemblé+Afpfp-

assisé::=+Afpms-
assisée::assisé+Afpfs-
assisés::assisé+Afpmp-
assisées::assisé+Afpfp-

astreint::=+Afpms-
astreinte::astreint+Afpfs-
astreints::astreint+Afpmp-
astreintes::astreint+Afpfp-

autobloquant::=+Afpms-
autobloquante::autobloquant+Afpfs-
autobloquants::autobloquant+Afpmp-
autobloquantes::autobloquant+Afpfp-

autobuté::=+Afpms-
autobutée::autobuté+Afpfs-
autobutés::autobuté+Afpmp-
autobutées::autobuté+Afpfp-

autocentré::=+Afpms-
autocentrée::autocentré+Afpfs-
autocentrés::autocentré+Afpmp-
autocentrées::autocentré+Afpfp-

autoclavé::=+Afpms-
autoclavée::autoclavé+Afpfs-
autoclavés::autoclavé+Afpmp-
autoclavées::autoclavé+Afpfp-

autocommande::=+Ncfs--
autocommandes::autocommande+Ncfp--

autocommandé::=+Afpms-
autocommandée::autocommandé+Afpfs-
autocommandés::autocommandé+Afpmp-
autocommandés::autocommandé+Afpfp-

autocommandé::=+Afpms-
autocommandée::autocommandé+Afpfs-
autocommandés::autocommandé+Afpmp-
autocommandés::autocommandé+Afpfp-

autoforeur::=+Afpms-
autoforeuse::autoforeur+Afpfs-
autoforeurs::autoforeur+Afpmp-
autoforeuses::autoforeur+Afpfp-

autolissant::=+Afpms-
autolissante::autolissant+Afpfs-
autolissants::autolissant+Afpmp-
autolissantes::autolissant+Afpfp-

autoperçeur::=+Afpms-
autoperçeuse::autoperçeur+Afpfs-
autoperçeurs::autoperçeur+Afpmp-
autoperçeuses::autoperçeur+Afpfp-

autoprotection::=+Ncfs--
autoprotections::autoprotection+Ncfp--

autoprotégé::=+Afpms-
autoprotégée::autoprotégé+Afpfs-
autoprotégés::autoprotégé+Afpmp-
autoprotégées::autoprotégé+Afpfp-

autoréglable::=+Afpms-
autoréglables::autoréglable+Afpmp-

autorégulant::=+Afpms-
autorégulante::autorégulant+Afpfs-
autorégulants::autorégulant+Afpmp-
autorégulantes::autorégulant+Afpfp-

autotaraudeur::=+Afpms-
autotaraudeuse::autotaraudeur+Afpfs-
autotaraudeurs::autotaraudeur+Afpmp-
autotaraudeuses::autotaraudeur+Afpfp-

aéroréfrigérant::=+Afpms-
aéroréfrigérante::aéroréfrigérant+Afpfs-
aéroréfrigérants::aéroréfrigérant+Afpmp-
aéroréfrigérantes::aéroréfrigérant+Afpfp-

barreaudage::=+Ncms--
barreaudages::barreaudage+Ncmp--

barrier::=+Ncms--
barriers::barrier+Ncmp--

bauteil::=+Ncms--
bauteils::bauteil+Ncmp--

beaume::=+Ncms--
beaumes::beaume+Ncmp--

berge::=+Ncfs--
berges::berge+Ncfp--

bessier::=+Afpms-
bessiere::bessier+Afpfs-
bessiers::bessier+Afpmp-
bessieres::bessier+Afpfp-

bezon::=+Ncms--
bezons::bezon+Ncmp--

bicomposant::=+Afpms-
bicomposante::bicomposant+Afpfs-
bicomposants::bicomposant+Afpmp-
bicomposantes::bicomposant+Afpfp-

bicouche::=+Afpms-
bicouches::bicouche+Afpmp-

bordé::=+Afpms-
bordée::bordé+Afpfs-
bordés::bordé+Afpmp-
bordées::bordé+Afpfp-

bornier::=+Ncms--
borniers::bornier+Ncmp--

bouchardage::=+Ncms--
bouchardages::bouchardage+Ncmp--

bouchement::=+Ncms--
bouchements::bouchement+Ncmp--

bourdette::=+Ncfs--
bourdettes::bourdette+Ncfp--

busette::=+Ncfs--
busettes::busette+Ncfp--

bûchage::=+Ncms--
bûchages::bûchage+Ncmp--

calculation::=+Ncfs--
calculations::calculation+Ncfp--

calibrateur::=+Afpms-
calibrateurs::calibrateur+Afpmp-

canalisateur::=+Afpms-
canalisateurs::canalisateur+Afpmp-

captant::=+Afpms-
captante::captant+Afpfs-
captants::captant+Afpmp-
captantes:captant+Afpfp-

captrice::=+Afpfs-
captrices::captrice+Afpfp-

chromaté::=+Afpms-
chromatée::chromaté+Afpfs-
chromatés::chromaté+Afpmp-
chromatées:chromaté+Afpfp-

chutage::=+Ncms--
chutages::chutage+Ncmp--

châtière::=+Ncfs--
châtières::châtière+Ncfp--

cintrable::=+Afpms-
cintrables::cintrable+Afpmp-

cirant::=+Afpms-
cirante::cirant+Afpfs-
cirants::cirant+Afpmp-
cirantes:cirant+Afpfp-

circonférentiel::=+Afpms-
circonférentielle::circonférentiel+Afpfs-
circonférentiels::circonférentiel+Afpmp-
circonférentielles:circonférentiel+Afpfp-

circuité::=+Afpms-
circuitée::circuité+Afpfs-
circuités::circuité+Afpmp-
circuitées:circuité+Afpfp-

circulable::=+Afpms-
circulables::circulable+Afpmp-

circulateur::=+Ncms--
circulateurs::circulateur+Ncmp--

clippé::=+Afpms-
clippée::clippé+Afpfs-
clippés::clippé+Afpmp-
clippées:clippé+Afpfp-

clipsé::=+Afpms-
clipsée::clipsé+Afpfs-
clipsés::clipsé+Afpmp-
clipsées:clipsé+Afpfp-

cloisonnette::=+Ncfs--
cloisonnettes::cloisonnette+Ncfp--

closoir::=+Ncms--
closoirs::closoir+Ncmp--

closure::=+Ncfs--
closures::closure+Ncfp--

cloueur::=+Afpms-
cloueuse::cloueur+Afpfs-
cloueurs::cloueur+Afpmp-
cloueuses::cloueur+Afpfp-

codificatif::=+Afpms-
codificative::codificatif+Afpfs-
codificatifs::codificatif+Afpmp-
codificatives:codificatif+Afpfp-

coffrant::=+Afpms-
coffrante::coffrant+Afpfs-
coffrants::coffrant+Afpmp-
coffrantes::coffrant+Afpfp-

coiffant::=+Afpms-
coiffante::coiffant+Afpfs-
coiffants::coiffant+Afpmp-
coiffantes::coiffant+Afpfp-

collaborant::=+Afpms-
collaborante::collaborant+Afpfs-
collaborants::collaborant+Afpmp-
collaborantes::collaborant+Afpfp-

colmatable::=+Afpms-
colmatables::colmatable+Afpmp-

colmatant::=+Afpms-
colmatante::colmatant+Afpfs-
colmatants::colmatant+Afpmp-
colmatantes::colmatant+Afpfp-

colorimétrique::=+Afpms-
colorimétriques::colorimétrique+Afpmp-

composé::=+Afpms-
composée::composé+Afpfs-
composés::composé+Afpmp-
composées::composé+Afpfp-

conchylicole::=+Afpms-
conchylicoles::conchylicole+Afpmp-

concédant::=+Afpms-
concédante::concédant+Afpfs-
concédants::concédant+Afpmp-
concédantes::concédant+Afpfp-

condensat::=+Ncms--
condensats::condensat+Ncmp--

conduisant::=+Afpms-
conduisante::conduisant+Afpfs-
conduisants::conduisant+Afpmp-
conduisantes::conduisant+Afpfp-

confortatif::=+Afpms-
confortative::confortatif+Afpfs-
confortatifs::confortatif+Afpmp-
confortatives:confortatif+Afpfp-

conservatif::=+Afpms-
conservative::conservatif+Afpfs-
conservatifs::conservatif+Afpmp-
conservatives:conservatif+Afpfp-

contaminant::=+Afpms-
contaminante::contaminant+Afpfs-
contaminants::contaminant+Afpmp-
contaminantes::contaminant+Afpfp-

contrastant::=+Afpms-
contrastante::contrastant+Afpfs-
contrastants::contrastant+Afpmp-
contrastantes::contrastant+Afpfp-

contrebride::=+Ncfs--
contrebrides::contrebride+Ncfp--

contrecloison::=+Ncfs--
contrecloisons::contrecloison+Ncfp--

contreflèche::=+Ncfs--
contreflèches::contreflèche+Ncfp--

contrelatte::=+Ncfs--
contrelattes::contrelatte+Ncfp--

contreparement::=+Ncms--
contreparements::contreparement+Ncmp--

contreparementé::=+Afpms-
contreparementée::contreparementé+Afpfs-
contreparementés::contreparementé+Afpmp-
contreparementées::contreparementé+Afpfp-

convectif::=+Afpms-
convective::convectif+Afpfs-
convectifs::convectif+Afpmp-
convectives:convectif+Afpfp-

corrodable::=+Afpms-
corrodables::corrodable+Afpmp-

cosigné::=+Afpms-
cosignée::cosigné+Afpfs-
cosignés::cosigné+Afpmp-
cosignées::cosigné+Afpfp-

cotraitant::=+Afpms-
cotraitante::cotraitant+Afpfs-
cotraitants::cotraitant+Afpmp-
cotraitantes::cotraitant+Afpfp-


coursan::=+Ncms--
coursans::coursan+Ncmp--

couturage::=+Ncms--
couturages::couturage+Ncmp--

crantage::=+Ncms--
crantages::crantage+Ncmp--

dallette::=+Ncfs--
dallettes::dallette+Ncfp--

diffusant::=+Afpms-
diffusante::diffusant+Afpfs-
diffusants::diffusant+Afpmp-
diffusantes::diffusant+Afpfp-

diluable::=+Afp.s-
diluables::diluable+Afp.p-

diluant::=+Ncms--
diluants::diluant+Ncmp--

discoloration::=+Ncfs--
discolorations::discoloration+Ncfp--

disconnecteur::=+Ncms--
disconnecteurs::disconnecteur+Ncmp--

discrétisé::=+Afpms-
discrétisée::discrétisé+Afpfs-
discrétisés::discrétisé+Afpmp-
discrétisées::discrétisé+Afpfp-

display::=+Ncms--
displays::display+Ncmp--

distancier:=+Ncms--
distanciers::distancier+Ncmp--

drainant::=+Afpms-
drainante::drainant+Afpfs-
drainants::drainant+Afpmp-
drainantes::drainant+Afpfp-

duraminisé::=+Afpms-
duraminisée::duraminisé+Afpfs-
duraminisés::duraminisé+Afpmp-
duraminisées::duraminisé+Afpfp-

débouchant::=+Ncms--
débouchants::débouchant+Ncmp--

décondamnable::=+Afp.s-
décondamnables::décondamnable+Afp.p-

décondamné::=+Afpms-
décondamnée::décondamné+Afpfs-
décondamnés::décondamné+Afpmp-
décondamnées::décondamné+Afpfp-

déconnectable::=+Afp.s-
déconnectables::déconnectable+Afp.p-

décrochable::=+Afp.s-
décrochables::décrochable+Afp.p-

déflection::=+Ncfs--
déflections::déflection+Ncfp--

déformabilité::=+Ncfs--
déformabilités::déformabilité+Ncfp--

dégression::=+Ncfs--
dégressions::dégression+Ncfp--

délamination::=+Ncfs--
délaminations::délamination+Ncfp--

délavant::=+Ncms--
délavants::délavant+Ncmp--

déligné::=+Afpms-
délignée::déligné+Afpfs-
délignés::déligné+Afpmp-
délignées::déligné+Afpfp-

démoulant::=+Afpms-
démoulante::démoulant+Afpfs-
démoulants::démoulant+Afpmp-
démoulantes::démoulant+Afpfp-

dénivelé::=+Afpms-
dénivelée::dénivelé+Afpfs-
dénivelés::dénivelé+Afpmp-
dénivelées::dénivelé+Afpfp-

dépassant::=+Afpms-
dépassante::dépassant+Afpfs-
dépassants::dépassant+Afpmp-
dépassantes::dépassant+Afpfp-

déplaçable::=+Afp.s-
déplaçables::déplaçable+Afp.p-

déprimogène::=+Afp.s-
déprimogènes::déprimogène+Afp.p-

dérapant::=+Afpms-
dérapante::dérapant+Afpfs-
dérapants::dérapant+Afpmp-
dérapantes::dérapant+Afpfp-

dérivateur::=+Afpms-
dérivateurs::dérivateur+Afpmp-

désaffleurement::=+Ncms--
désaffleurements::désaffleurement+Ncmp--

désaffleur::=+Ncms--
désaffleurs::désaffleur+Ncmp--

désaxement::=+Ncms--
désaxements::désaxement+Ncmp--

désenfumable::=+Ncms--
désenfumables::désenfumable+Ncmp--

déstockage::=+Ncms--
déstockages::déstockage+Ncmp--

détensionné::=+Afpms-
détensionnée::détensionné+Afpfs-
détensionnés::détensionné+Afpmp-
détensionnées::détensionné+Afpfp-

déverseur::=+Ncms--
déverseurs::déverseur+Ncmp--

emboîtant::=+Afpms-
emboîtante::emboîtant+Afpfs-
emboîtants::emboîtant+Afpmp-
emboîtantes::emboîtant+Afpfp-

empoussièrement::=+Ncms--
empoussièrements::empoussièrement+Ncmp--

encadrant::=+Afpms-
encadrante::encadrant+Afpfs-
encadrants::encadrant+Afpmp-
encadrantes::encadrant+Afpfp-

encloisonné::=+Afpms-
encloisonnée::encloisonné+Afpfs-
encloisonnés::encloisonné+Afpmp-
encloisonnées::encloisonné+Afpfp-

encoffrement::=+Ncms--
encoffrements::encoffrement+Ncmp--

entendant::=+Afpms-
entendante::entendant+Afpfs-
entendants::entendant+Afpmp-
entendantes::entendant+Afpfp-

enture::=+Ncms--
entures::enture+Ncmp--

espaceur::=+Ncms--
espaceurs::espaceur+Ncmp--

essentage::=+Ncms--
essentages::essentage+Ncmp--

etanchéité::=+Ncfs--
etanchéités::etanchéité+Ncfp--

eurocode::=+Ncms--
eurocodes::eurocode+Ncmp--

excentrement::=+Ncms--
excentrements::excentrement+Ncmp--

façadier::=+Ncms--
façadiers::façadier+Ncmp--

feuilluré::=+Afpms-
feuillurée::feuilluré+Afpfs-
feuillurés::feuilluré+Afpmp-
feuillurées::feuilluré+Afpfp-

fibragglo::=+Ncms--
fibragglos::fibragglo+Ncmp--

fibré::=+Afpms-
fibrée::fibré+Afpfs-
fibrés::fibré+Afpmp-
fibrées::fibré+Afpfp-

filonnet::=+Ncms--
filonnets::filonnet+Ncmp--

fissurant::=+Afpms-
fissurante::fissurant+Afpfs-
fissurants::fissurant+Afpmp-
fissurantes::fissurant+Afpfp-

fixant::=+Afpms-
fixante::fixant+Afpfs-
fixants::fixant+Afpmp-
fixantes::fixant+Afpfp-

flooring::=+Ncms--
floorings::flooring+Ncmp--

fléchissant::=+Afpms-
fléchissante::fléchissant+Afpfs-
fléchissants::fléchissant+Afpmp-
fléchissantes::fléchissant+Afpfp-

fonçure::=+Ncfs--
fonçures::fonçure+Ncfp--

formulateur::=+Ncms--
formulateurs::formulateur+Ncmp--

fractile::=+Afpms-
fractiles::fractile+Afpmp-

frigoporteur::=+Ncms--
frigoporteurs::frigoporteur+Ncmp--

frotture::=+Ncfs--
frottures::frotture+Ncfp--

frotté::=+Afpms-
frottée::frotté+Afpfs-
frottés::frotté+Afpmp-
frottées::frotté+Afpfp-

gambardière::=+Ncfs--
gambardières::gambardière+Ncfp--

garnissant::=+Afpms-
garnissante::garnissant+Afpfs-
garnissants::garnissant+Afpmp-
garnissantes::garnissant+Afpfp-

gazonnière::=+Ncfs--
gazonnières::gazonnière+Ncfp--

giclant::=+Afpms-
giclante::giclant+Afpfs-
giclants::giclant+Afpmp-
giclantes::giclant+Afpfp-

gondé::=+Afpms-
gondée::gondé+Afpfs-
gondés::gondé+Afpmp-
gondées::gondé+Afpfp-

gonflant::=+Afpms-
gonflante::gonflant+Afpfs-
gonflants::gonflant+Afpmp-
gonflantes::gonflant+Afpfp-

granularité::=+Ncfs--
granularités::granularité+Ncfp--

grappier::=+Ncms--
grappiers::grappier+Ncmp--

gravitaire::=+Afp.s-
gravitaires::gravitaire+Afp.p-

géomembrane::=+Ncfs--
géomembranes::géomembrane+Ncfp--

géotechnicien::=+Ncms--
géotechniciens::géotechnicien+Ncmp--
géotechnicienne::géotechnicien+Ncfs--
géotechniciennes::géotechnicien+Ncfp--

harpage::=+Ncms--
harpages::harpage+Ncmp--

homopolymère::=+Ncms--
homopolymères::homopolymère+Ncmp--

hydrobiologique::=+Afp.s-
hydrobiologiques::hydrobiologique+Afp.p-

hydrocarburé::=+Afpms-
hydrocarburée::hydrocarburé+Afpfs-
hydrocarburés::hydrocarburé+Afpmp-
hydrocarburées::hydrocarburé+Afpfp-

hydrogéologique::=+Afp.s-
hydrogéologiques::hydrogéologique+Afp.p-

hydrogéologue::=+Ncms--
hydrogéologues::hydrogéologue+Ncmp--

hygroréglable::=+Afp.s-
hygroréglables::hygroréglable+Afp.p-

hygrothermique::=+Afp.s-
hygrothermiques::hygrothermique+Afp.p-

imperméabilisant::=+Ncms--
imperméabilisants::imperméabilisant+Ncmp--

imprégnable::=+Afp.s-
imprégnables::imprégnable+Afp.p-

impulsionnel::=+Afpms-
impulsionnelle::impulsionnel+Afpfs-
impulsionnels::impulsionnel+Afpmp-
impulsionnelles::impulsionnel+Afpfp-

inclinométrique::=+Afp.s-
inclinométriques::inclinométrique+Afp.p-

incorrodable::=+Afp.s-
incorrodables::incorrodable+Afp.p-

indesserrable::=+Afp.s-
indesserrables::indesserrable+Afp.p-

insonorisant::=+Ncms--
insonorisants::insonorisant+Ncmp--

interrelation::=+Ncfs--
interrelations::interrelation+Ncfp--

intratropical::=+Afpms-
intratropicale::intratropical+Afpfs-
intratropicals::intratropical+Afpmp-
intratropicales::intratropical+Afpfp-

ischyatique::=+Afp.s-
ischyatiques::ischyatique+Afp.p-

isocyanate::=+Afp.s-
isocyanates::isocyanate+Afp.p-

isophonique::=+Afp.s-
isophoniques::isophonique+Afp.p-

isothermique::=+Afp.s-
isothermiques::isothermique+Afp.p-

kilowatt::=+Ncms--
kilowatts::kilowatt+Ncmp--

labellisé::=+Afpms-
labellisée::labellisé+Afpfs-
labellisés::labellisé+Afpmp-
labellisées::labellisé+Afpfp-

levant::=+Afpms-
levante::levant+Afpfs-
levants::levant+Afpmp-
levantes::levant+Afpfp-

lignocellulosique::=+Afp.s-
lignocellulosiques::lignocellulosique+Afp.p-

luminancemètre::=+Ncms--
luminancemètres::luminancemètre+Ncmp--

légionelle::=+Ncfs--
légionelles::légionelle+Ncfp--

majorateur::=+Ncms--
majorateurs::majorateur+Ncmp--

maniabilimètre::=+Ncms--
maniabilimètres::maniabilimètre+Ncmp--

microcoulomb::=+Ncms--
microcoulombs::microcoulomb+Ncmp--

microcurie::=+Ncms--
microcuries::microcurie+Ncmp--

micromanomètre::=+Ncms--
micromanomètres::micromanomètre+Ncmp--

minorateur::=+Ncms--
minorateurs::minorateur+Ncmp--

monocombustible::=+Ncms--
monocombustibles::monocombustible+Ncmp--

monocomposant::=+Ncms--
monocomposants::monocomposant+Ncmp--

monocouche::=+Ncfs--
monocouches::monocouche+Ncfp--

monodimensionnel::=+Afpms-
monodimensionnelle::monodimensionnel+Afpfs-
monodimensionnels::monodimensionnel+Afpmp-
monodimensionnelles::monodimensionnel+Afpfp-

monogranulaire::=+Afp.s-
monogranulaires::monogranulaire+Afp.p-

moussant::=+Afpms-
moussante::moussant+Afpfs-
moussants::moussant+Afpmp-
moussantes::moussant+Afpfp-

moyenneur::=+Ncms--
moyenneurs::moyenneur+Ncmp--

moëllon::=+Ncms--
moëllons::moëllon+Ncmp--

muffler::=+Ncms--
mufflers::muffler+Ncmp--

multichambre::=+Afp.s-
multichambres::multichambre+Afp.p-

multiconducteur::=+Afp.s-
multiconducteurs::multiconducteur+Afp.p-

multidirectionnel::=+Afpms-
multidirectionnelle::multidirectionnel+Afpfs-
multidirectionnels::multidirectionnel+Afpmp-
multidirectionnelles::multidirectionnel+Afpfp-

multifonctionnel::=+Afpms-
multifonctionnelle::multifonctionnel+Afpfs-
multifonctionnels::multifonctionnel+Afpmp-
multifonctionnelles::multifonctionnel+Afpfp-

multimodule::=+Afp.s-
multimodules::multimodule+Afp.p-

multiparoi::=+Afp.s-
multiparois::multiparoi+Afp.p-

mégapascal::=+Ncms--
mégapascals::mégapascal+Ncmp--

mésoclimat::=+Ncms--
mésoclimats::mésoclimat+Ncmp--

mésothéliome::=+Ncms--
mésothéliomes::mésothéliome+Ncmp--

nettoyable::=+Afp.s-
nettoyables::nettoyable+Afp.p-

nettoyant::=+Ncms--
nettoyants::nettoyant+Ncmp--

nuançage::=+Ncms--
nuançages::nuançage+Ncmp--

obturable::=+Afp.s-
obturables::obturable+Afp.p-

odorisé::=+Afpms-
odorisée::odorisé+Afpfs-
odorisés::odorisé+Afpmp-
odorisées::odorisé+Afpfp-

oedomètre::=+Ncms--
oedomètres::oedomètre+Ncmp--

oléoplastique::=+Ncms--
oléoplastiques::oléoplastique+Ncmp--
oléoplastique::=+Afp.s-
oléoplastiques::oléoplastique+Afp.p-


opacifiant::=+Afpms-
opacifiante::opacifiant+Afpfs-
opacifiants::opacifiant+Afpmp-
opacifiantes::opacifiant+Afpfp-

palpeuse::=+Afpfs-
palpeuses::palpeuse+Afpfp-

parasitologique::=+Afp.s-
parasitologiques::parasitologique+Afp.p-

pariétodynamique::=+Afp.s-
pariétodynamiques::pariétodynamique+Afp.p-

pelable::=+Afp.s-
pelables::pelable+Afp.p-

performanciel::=+Afpms-
performancielle::performanciel+Afpfs-
performanciels::performanciel+Afpmp-
performancielles::performanciel+Afpfp-

perlant::=+Afpms-
perlante::perlant+Afpfs-
perlants::perlant+Afpmp-
perlantes::perlant+Afpfp-

perméance::=+Ncms--
perméances::perméance+Ncmp--

perméant::=+Afpms-
perméante::perméant+Afpfs-
perméants::perméant+Afpmp-
perméantes::perméant+Afpfp-

persienné::=+Afpms-
persiennée::persienné+Afpfs-
persiennés::persienné+Afpmp-
persiennées::persienné+Afpfp-

phasage::=+Ncms--
phasages::phasage+Ncmp--

pistoscellement::=+Ncms--
pistoscellements::pistoscellement+Ncmp--

piètement::=+Ncms--
piètements::piètement+Ncmp--

piéton::=+Afpms-
piétonne::piéton+Afpfs-
piétons::piéton+Afpmp-
piétonnes::piéton+Afpfp-

piézométrique::=+Afp.s-
piézométriques::piézométrique+Afp.p-

plombable::=+Afp.s-
plombables::plombable+Afp.p-

plombant::=+Afpms-
plombante::plombant+Afpfs-
plombants::plombant+Afpmp-
plombantes::plombant+Afpfp-

pluricomposant::=+Ncms--
pluricomposants::pluricomposant+Ncmp--

pochage::=+Ncms--
pochages::pochage+Ncmp--

poinçonnant::=+Afpms-
poinçonnante::poinçonnant+Afpfs-
poinçonnants::poinçonnant+Afpmp-
poinçonnantes::poinçonnant+Afpfp-

polochonnage::=+Ncms--
polochonnages::polochonnage+Ncmp--

polochonné::=+Afpms-
polochonnée::polochonné+Afpfs-
polochonnés::polochonné+Afpmp-
polochonnées::polochonné+Afpfp-

polychloroprène::=+Ncms--
polychloroprènes::polychloroprène+Ncmp--

polycombustible::=+Ncms--
polycombustibles::polycombustible+Ncmp--

polyméthacrylate::=+Ncms--
polyméthacrylates::polyméthacrylate+Ncmp--

polyéther::=+Ncms--
polyéthers::polyéther+Ncmp--

pompable::=+Afp.s-
pompables::pompable+Afp.p-

postformable::=+Afp.s-
postformables::postformable+Afp.p-

pourcentile::=+Ncms--
pourcentiles::pourcentile+Ncmp--

pouzzolanique::=+Afp.s-
pouzzolaniques::pouzzolanique+Afp.p-

pressiométrique::=+Afp.s-
pressiométriques::pressiométrique+Afp.p-

projetable::=+Afp.s-
projetables::projetable+Afp.p-

préassemblé::=+Afpms-
préassemblée::préassemblé+Afpfs-
préassemblés::préassemblé+Afpmp-
préassemblées::préassemblé+Afpfp-

précadre::=+Ncms--
précadres::précadre+Ncmp--

précalculé::=+Afpms-
précalculée::précalculé+Afpfs-
précalculés::précalculé+Afpmp-
précalculées::précalculé+Afpfp-

préconditionné::=+Afpms-
préconditionnée::préconditionné+Afpfs-
préconditionnés::préconditionné+Afpmp-
préconditionnées::préconditionné+Afpfp-

précultivé::=+Afpms-
précultivée::précultivé+Afpfs-
précultivés::précultivé+Afpmp-
précultivées::précultivé+Afpfp-

préconisation::=+Ncfs--
préconisations::préconisation+Ncfp--

prédalle::=+Ncfs--
prédalles::prédalle+Ncfp--

prédosé::=+Afpms-
prédosée::prédosé+Afpfs-
prédosés::prédosé+Afpmp-
prédosées::prédosé+Afpfp-

préenduit::=+Afpms-
préenduite::préenduit+Afpfs-
préenduits::préenduit+Afpmp-
préenduites::préenduit+Afpfp-

préextrudé::=+Afpms-
préextrudée::préextrudé+Afpfs-
préextrudés::préextrudé+Afpmp-
préextrudées::préextrudé+Afpfp-

préfiltre::=+Ncms--
préfiltres::préfiltre+Ncmp--

préforage::=+Ncms--
préforages::préforage+Ncmp--

préextrudé::=+Afpms-
préextrudée::préextrudé+Afpfs-
préextrudés::préextrudé+Afpmp-
préextrudées::préextrudé+Afpfp-

préfourreauté::=+Afpms-
préfourreautée::préfourreauté+Afpfs-
préfourreautés::préfourreauté+Afpmp-
préfourreautées::préfourreauté+Afpfp-

prégainé::=+Afpms-
prégainée::prégainé+Afpfs-
prégainés::prégainé+Afpmp-
prégainées::prégainé+Afpfp-

préisolé::=+Afpms-
préisolée::préisolé+Afpfs-
préisolés::préisolé+Afpmp-
préisolées::préisolé+Afpfp-

prémélangé::=+Afpms-
prémélangée::prémélangé+Afpfs-
prémélangés::prémélangé+Afpmp-
prémélangées::prémélangé+Afpfp-

prénorme::=+Ncfs--
prénormes::prénorme+Ncfp--

prépercé:=+Afpms-
prépercée::prépercé+Afpfs-
prépercés::prépercé+Afpmp-
prépercées::prépercé+Afpfp-

prépeint::=+Afpms-
prépeinte::prépeint+Afpfs-
prépeints::prépeint+Afpmp-
prépeintes::prépeint+Afpfp-

prépatiné::=+Afpms-
prépatinée::prépatiné+Afpfs-
prépatinés::prépatiné+Afpmp-
prépatinées::prépatiné+Afpfp-

préperçage::=+Ncms--
préperçages::préperçage+Ncmp--

prétraitement::=+Ncms--
prétraitements::prétraitement+Ncmp--

prérevêtu::=+Afpms-
prérevêtue::prérevêtu+Afpfs-
prérevêtus::prérevêtu+Afpmp-
prérevêtues::prérevêtu+Afpfp-

prépeint::=+Afpms-
prépeint::prépeint+Afpfs-
prépeints::prépeint+Afpmp-
prépeintes::prépeint+Afpfp-

pulseur::=+Ncms--
pulseurs::pulseur+Ncmp--

pyranomètre::=+Ncms--
pyranomètres::pyranomètre+Ncmp--

pyrradiomètre::=+Ncms--
pyrradiomètres::pyrradiomètre+Ncmp--

pénétrométrique::=+Afp.s-
pénétrométriques::pénétrométrique+Afp.p-

périmétral::=+Afpms-
périmétrale::périmétral+Afpfs-
périmétrals::périmétral+Afpmp-
périmétrales::périmétral+Afpfp-

péture::=+Ncfs--
pétures::péture+Ncfp--

rabattable::=+Afp.s-
rabattables::rabattable+Afp.p-

rabattant::=+Ncms--
rabattants::rabattant+Ncmp--

raboutage::=+Ncms--
raboutages::raboutage+Ncmp--

raccordable::=+Afp.s-
raccordables::raccordable+Afp.p-

radionucléide::=+Ncfs--
radionucléides::radionucléide+Ncfp--

ragréage::=+Ncms--
ragréages::ragréage+Ncmp--

ramonable::=+Afp.s-
ramonables::ramonable+Afp.p-

ravoirage::=+Ncms--
ravoirages::ravoirage+Ncmp--

rebroyable::=+Afp.s-
rebroyables::rebroyable+Afp.p-

reconfirmé::=+Afpms-
reconfirmée::reconfirmé+Afpfs-
reconfirmés::reconfirmé+Afpmp-
reconfirmées::reconfirmé+Afpfp-

recouvrant::=+Afpms-
recouvrante::recouvrant+Afpfs-
recouvrants::recouvrant+Afpmp-
recouvrantes::recouvrant+Afpfp-

refoulant::=+Afpms-
refoulante::refoulant+Afpfs-
refoulants::refoulant+Afpmp-
refoulantes::refoulant+Afpfp-

rejingot::=+Ncms--
rejingots::rejingot+Ncmp--

relargage::=+Ncms--
relargages::relargage+Ncmp--

relevant::=+Afpms-
relevante::relevant+Afpfs-
relevants::relevant+Afpmp-
relevantes::relevant+Afpfp-

replaqué::=+Afpms-
replaquée::replaqué+Afpfs-
replaqués::replaqué+Afpmp-
replaquées::replaqué+Afpfp-

respirant::=+Afpms-
respirante::respirant+Afpfs-
respirants::respirant+Afpmp-
respirantes::respirant+Afpfp-

ruellé::=+Afpms-
ruellée::ruellé+Afpfs-
ruellés::ruellé+Afpmp-
ruellées::ruellé+Afpfp-

règlementaire::=+Afp.s-
règlementaires::règlementaire+Afp.p-

règlementation::=+Ncfs--
règlementations::règlementation+Ncfp--

réalimenté::=+Afpms-
réalimentée::réalimenté+Afpfs-
réalimentés::réalimenté+Afpmp-
réalimentées::réalimenté+Afpfp-

réarmable::=+Ncms--
réarmables::réarmable+Ncmp--

réenclenchement::=+Ncms--
réenclenchements::réenclenchement+Ncmp--

réflection::=+Ncfs--
réflections::réflection+Ncfp--

réhumidifié::=+Afpms-
réhumidifiée::réhumidifié+Afpfs-
réhumidifiés::réhumidifié+Afpmp-
réhumidifiées::réhumidifié+Afpfp-

réinitialisé::=+Afpms-
réinitialisée::réinitialisé+Afpfs-
réinitialisés::réinitialisé+Afpmp-
réinitialisées::réinitialisé+Afpfp-

résiliant::=+Afpms-
résiliante::résiliant+Afpfs-
résiliants::résiliant+Afpmp-
résiliantes::résiliant+Afpfp-

résultant::=+Afpms-
résultante::résultant+Afpfs-
résultants::résultant+Afpmp-
résultantes::résultant+Afpfp-

rétroréflecteur::=+Ncms--
rétroréflecteurs::rétroréflecteur+Ncmp--

rétroréfléchissant::=+Afpms-
rétroréfléchissante::rétroréfléchissant+Afpfs-
rétroréfléchissants::rétroréfléchissant+Afpmp-
rétroréfléchissantes::rétroréfléchissant+Afpfp-

réverbérant::=+Afpms-
réverbérante::réverbérant+Afpfs-
réverbérants::réverbérant+Afpmp-
réverbérantes::réverbérant+Afpfp-

réétalonné::=+Afpms-
réétalonnée::réétalonné+Afpfs-
réétalonnés::réétalonné+Afpmp-
réétalonnées::réétalonné+Afpfp-

savin::=+Afpms-
savine::savin+Afpfs-
savins::savin+Afpmp-
savines::savin+Afpfp-

scissométrique::=+Afp.s-
scissométriques::scissométrique+Afp.p-

sclérométrique::=+Afp.s-
sclérométriques::sclérométrique+Afp.p-

savin::=+Afpms-
savine::savin+Afpfs-
savins::savin+Afpmp-
savines::savin+Afpfp-

sectional::=+Afpms-
sectionale::sectional+Afpfs-
sectionals::sectional+Afpmp-
sectionales::sectional+Afpfp-

siliconé::=+Afpms-
siliconée::siliconé+Afpfs-
siliconés::siliconé+Afpmp-
siliconées::siliconé+Afpfp-

siphonnage::=+Ncms--
siphonnages::siphonnage+Ncmp--

smectite::=+Ncfs--
smectites::smectite+Ncfp--

sodocalcique::=+Afp.s-
sodocalciques::sodocalcique+Afp.p-

solage::=+Ncms--
solages::solage+Ncmp--

solidien::=+Afpms-
solidienne::solidien+Afpfs-
solidiens::solidien+Afpmp-
solidiennes::solidien+Afpfp-

sollicitant::=+Afpms-
sollicitante::sollicitant+Afpfs-
sollicitants::sollicitant+Afpmp-
sollicitantes::sollicitant+Afpfp-

solvanté::=+Afpms-
solvantée::solvanté+Afpfs-
solvantés::solvanté+Afpmp-
solvantées::solvanté+Afpfp-

spiralage::=+Ncms--
spiralages::spiralage+Ncmp--

splité::=+Afpms-
splitée::splité+Afpfs-
splités::splité+Afpmp-
splitées::splité+Afpfp-

sprinkleur::=+Ncms--
sprinkleurs::sprinkleur+Ncmp--

spécificateur::=+Ncms--
spécificateurs::spécificateur+Ncmp--

stabilisant::=+Afpms-
stabilisante::stabilisant+Afpfs-
stabilisants::stabilisant+Afpmp-
stabilisantes::stabilisant+Afpfp-

stylolite::=+Ncms--
stylolites::stylolite+Ncmp--

subventionnable::=+Afp.s-
subventionnables::subventionnable+Afp.p-

superplastifiant::=+Afpms-
superplastifiante::superplastifiant+Afpfs-
superplastifiants::superplastifiant+Afpmp-
superplastifiantes::superplastifiant+Afpfp-

superpolyamide::=+Ncms--
superpolyamides::superpolyamide+Ncmp--

superpolyamide::=+Ncms--
superpolyamides::superpolyamide+Ncmp--

supportage::=+Ncms--
supportages::supportage+Ncmp--

supportant::=+Ncms--
supportants::supportant+Ncmp--

surbille::=+Ncfs--
surbilles::surbille+Ncfp--

surdimensionné::=+Afpms-
surdimensionnée::surdimensionné+Afpfs-
surdimensionnés::surdimensionné+Afpmp-
surdimensionnées::surdimensionné+Afpfp-

suremballage::=+Ncms--
suremballages::suremballage+Ncmp--

surfaçé::=+Afpms-
surfaçée::surfaçé+Afpfs-
surfaçés::surfaçé+Afpmp-
surfaçées::surfaçé+Afpfp-

surlargeur::=+Ncfs--
surlargeurs::surlargeur+Ncfp--

surprofondeur::=+Ncfs--
surprofondeurs::surprofondeur+Ncfp--

surverse::=+Ncfs--
surverses::surverse+Ncfp--

surpressé::=+Afpms-
surpressée::surpressé+Afpfs-
surpressés::surpressé+Afpmp-
surpressées::surpressé+Afpfp-

syphon::=+Ncms--
syphons::syphon+Ncmp--

tachage::=+Ncms--
tachages::tachage+Ncmp--

tachant::=+Afpms-
tachants::tachant+Afpfs-
tachante::tachant+Afpmp-
tachantes::tachant+Afpfp-

tamisat::=+Ncms--
tamisats::tamisat+Ncmp--

tasseautage::=+Ncms--
tasseautages::tasseautage+Ncmp--

tavaillon::=+Ncms--
tavaillons::tavaillon+Ncmp--

tachage::=+Ncms--
tachages::tachage+Ncmp--

termité::=+Afpms-
termités::termité+Afpfs-
termitée::termité+Afpmp-
termitées::termité+Afpfp-

terpolymère::=+Ncms--
terpolymères::terpolymère+Ncmp--

thermocollant::=+Afpms-
thermocollante::thermocollant+Afpfs-
thermocollants::thermocollant+Afpmp-
thermocollantes::thermocollant+Afpfp-

thermolaquage::=+Ncms--
thermolaquages::thermolaquage+Ncmp--

thermolaqué::=+Afpms-
thermolaquée::thermolaqué+Afpfs-
thermolaqués::thermolaqué+Afpmp-
thermolaquées::thermolaqué+Afpfp-

thermomodulant::=+Afpms-
thermomodulante::thermomodulant+Afpfs-
thermomodulants::thermomodulant+Afpmp-
thermomodulantes::thermomodulant+Afpfp-

thermostaté::=+Afpms-
thermostatée::thermostaté+Afpfs-
thermostatés::thermostaté+Afpmp-
thermostatées::thermostaté+Afpfp-

thermomécanique::=+Afp.s-
thermomécaniques::thermomécanique+Afp.p-

thermorétractable::=+Afp.s-
thermorétractables::thermorétractable+Afp.p-

thixotropique::=+Afp.s-
thixotropiques::thixotropique+Afp.p-

tirefond::=+Ncms--
tirefonds::tirefond+Ncmp--

tolérancé::=+Afpms-
tolérancée::tolérancé+Afpfs-
tolérancés::tolérancé+Afpmp-
tolérancées::tolérancé+Afpfp-

touffeté::=+Afpms-
touffetée::touffeté+Afpfs-
touffetés::touffeté+Afpmp-
touffetées::touffeté+Afpfp-

tranversal::=+Afpms-
tranversale::tranversal+Afpfs-
tranversals::tranversal+Afpmp-
tranversales::tranversal+Afpfp-

traversant::=+Afpms-
traversante::traversant+Afpfs-
traversants::traversant+Afpmp-
traversantes::traversant+Afpfp-

trempé::=+Afpms-
trempée::trempé+Afpfs-
trempés::trempé+Afpmp-
trempées::trempé+Afpfp-

trichromatique::=+Afp.s-
trichromatiques::trichromatique+Afp.p-

tulipage::=+Ncms--
tulipages::tulipage+Ncmp--

typifié::=+Afpms-
typifiée::typifié+Afpfs-
typifiés::typifié+Afpmp-
typifiées::typifié+Afpfp-

télétransmis::=+Afpms-
télétransmise::télétransmis+Afpfs-
télétransmis::télétransmis+Afpmp-
télétransmises::télétransmis+Afpfp-

unifamilial::=+Afpms-
unifamiliale::unifamilial+Afpfs-
unifamilials::unifamilial+Afpmp-
unifamiliales::unifamilial+Afpfp-

urbanistique::=+Afp.s-
urbanistiques::urbanistique+Afp.p-

vacuomètre::=+Ncms--
vacuomètres::vacuomètre+Ncmp--

veinage::=+Ncms--
veinages::veinage+Ncmp--

valorisable::=+Afp.s-
valorisables::valorisable+Afp.p-

verrouillable::=+Afp.s-
verrouillables::verrouillable+Afp.p-

vibrofoncé::=+Afpms-
vibrofoncée::vibrofoncé+Afpfs-
vibrofoncés::vibrofoncé+Afpmp-
vibrofoncées::vibrofoncé+Afpfp-

vélocimétrique::=+Afp.s-
vélocimétriques::vélocimétrique+Afp.p-

vériné::=+Afpms-
vérinée::vériné+Afpfs-
vérinés::vériné+Afpmp-
vérinées::vériné+Afpfp-

vêtage::=+Ncms--
vêtages::vêtage+Ncmp--

xylolithe::=+Ncms--
xylolithes::xylolithe+Ncmp--

échangeur::=+Afpms-
échangeuse::échangeur+Afpfs-
échangeurs::échangeur+Afpmp-
échangeuses::échangeur+Afpfp-

éclissage::=+Ncms--
éclissages::éclissage+Ncmp--

écrêteur::=+Ncms--
écrêteurs::écrêteur+Ncmp--

éducteur::=+Ncms--
éducteurs::éducteur+Ncmp--

électromécanisme::=+Ncms--
électromécanismes::électromécanisme+Ncmp--

électrozingué::=+Afpms-
électrozinguée::électrozingué+Afpfs-
électrozingués::électrozingué+Afpmp-
électrozinguées::électrozingué+Afpfp-

équipé::=+Afpms-
équipée::équipé+Afpfs-
équipés::équipé+Afpmp-
équipées::équipé+Afpfp-

équivalant::=+Afpms-
équivalante::équivalant+Afpfs-
équivalants::équivalant+Afpmp-
équivalantes::équivalant+Afpfp-

étanchéifié::=+Afpms-
étanchéifiée::étanchéifié+Afpfs-
étanchéifiés::étanchéifié+Afpmp-
étanchéifiées::étanchéifié+Afpfp-

étuvé::=+Afpms-
étuvée::étuvé+Afpfs-
étuvés::étuvé+Afpmp-
étuvées::étuvé+Afpfp-

émissivité::=+Ncfs--
émissivités::émissivité+Ncfp--

équipotentialité::=+Ncfs--
équipotentialités::équipotentialité+Ncfp--

étancheur::=+Ncms--
étancheurs::étancheur+Ncmp--

jouxtant::=+Afpms-
jouxtante::jouxtant+Afpfs-
jouxtants::jouxtant+Afpmp-
jouxtantes::jouxtant+Afpfp-

lambourdage::=+Ncms--
lambourdages::lambourdage+Ncmp--

noquet::=+Ncms--
noquets::noquet+Ncmp--

nosocomial::=+Afpms-
nosocomiale::nosocomial+Afpfs-
nosocomials::nosocomial+Afpmp-
nosocomiales::nosocomial+Afpfp-

parasurtension::=+Ncfs--
parasurtensions::parasurtension+Ncfp--

perment::=+Ncms--
perments::perment+Ncmp--


